R 1000 1000

NO ./path_to_the_north_texture

EA ./path_to_the_south_texture

WE ./path_to_the_west_texture

SO ./path_to_the_east_texture

S ./path_to_the_sprite_texture

F 220,100,0

C 225,30,0





 11111111111111111111111111111111111
        1000020000210000000000001
        101100000111000002000000111111111
        10010000011 111111110000000000001
1111111110110000010100000000000011111111
10000000011000001110111111111111
11110111111111011100000010001
11110111111111011101010010001
11001000110101011100020010001
10012100200000001100000010001
10001000020000001101010010001
1101001110101011111011110N011
11110111 1110101 101111010001
11111111 1111111 111111111111
