R 960 540

NO ./texturesMinecraft_hi/stone.xpm

EA ./texturesMinecraft_hi/brick.xpm

WE ./texturesMinecraft_hi/wood.xpm

SO ./texturesMinecraft_hi/grass.xpm

S ./path_to_the_sprite_texture

F 130,59,0

C 217,244,255

 11111111111111111111111111111111111
        1000020000210000000000001
        101100000111000002000000111111111
        10010000011 111111110000000000001
1111111110110000010100000000000011111111
10000000011000001110111111111111
11110111111111011100000010001
11110111111111011101010010001
1100100011010101110E020010001
10012100200000001100000010001
10001000020000001101010010001
11010011101010111110111100011
11110111 1110101 101111010001
11111111 1111111 111111111111
