R 899 900

NO ./path_to_the_north_texture

EA ./path_to_the_south_texture

WE ./path_to_the_west_texture

SO ./path_to_the_east_texture

S ./path_to_the_sprite_texture

F 220,100,0

C 225,30,0

111111111111111111111111111111111111
111111111100000000000000011111011111
111100000000001110000011110001111111
100000000000000000000000000000000001
111100000000000W00000000000011111111
111111111100000000000001111000111111
111111111111111100001001111000111111
111111111111111111000000000000111111
11111111111111111111110001111111111
11111111111111111111111111
