R 500 500

NO ./texturesMinecraft/stone.xpm

EA ./texturesMinecraft/brick.xpm

WE ./texturesMinecraft/wood.xpm

SO ./texturesMinecraft/grass.xpm

S ./texturesMinecraft/eagle.xpm

F 130,59,0

C 217,244,255

111111111111111111111111111111111111
111111111100000000000000011111011111
111100000000001110000011110001111111
100000000000000000000000000000000001
111100000000000W00000000000011111111
111111111100000000000001111000111111
111111111111111100001001111000111111
111111111111111111000000000000111111
11111111111111111111110001111111111
1111111111 11111111111111 
