R 900 500

NO ./texturesMinecraft_hi/stone.xpm

EA ./texturesMinecraft_hi/brick.xpm

WE ./texturesMinecraft/wood.xpm

SO ./texturesMinecraft/stone.xpm

S ./texturesMinecraft/eagle.xpm

F 130,59,0

C 217,244,255

 111111111
10000000001
10000200001
12000000001
10000000001
10000W00201
10000000001
10000000001
10200000001
10000000201
 111111111
