R 1000 1000

NO ./path_to_the_north_texture

EA ./path_to_the_south_texture

WE ./path_to_the_west_texture

SO ./path_to_the_east_texture

S ./path_to_the_sprite_texture

F 220,100,0

C 225,30,0

 111111111
10000000001
10000000001
10000000001
10000000001
10000W00001
10000000001
10000000001
10000000001
10000000001
 111111111
