R 900 500

NO ./texturesMinecraft_hi/stone.xpm

EA ./texturesMinecraft_hi/brick.xpm

WE ./texturesMinecraft_hi/wood.xpm

SO ./texturesMinecraft_hi/grass.xpm

S ./path_to_the_sprite_texture

F 130,59,0

C 217,244,255

 111111111
10000000001
10000200001
10000000001
10000000001
10200W00201
10000000001
10000000001
10000200001
10000000001
 111111111
