R 400 400

NO ./textures/stone.xpm

EA ./textures/brick.xpm

WE ./textures/wood.xpm

SO ./textures/grass.xpm

S ./textures/vase2.xpm

F 250,170,104

C 177,253,255

111111111111111111111111111111111111
111111111100000000000200011111011111
111100000000001110000011110001111111
100000002000000002000000000000E00021
1111000000000000000000000000011111111
111111111100000000200001111200111111
111111111111111100001001111000111111
111111111111111111000000002000111111
11111111111111111111110001111111111
1111111111 11111111111111 
