R 600 600

NO ./texturesMinecraft_hi/stone.xpm

EA ./texturesMinecraft_hi/brick.xpm

WE ./texturesMinecraft/wood.xpm

SO ./texturesMinecraft/stone.xpm

S ./texturesMinecraft/eagle.xpm

F 250,205,211

C 217,244,255

 111111111
10000000001
10000000001
10111110001
10100010001
10111110001
10000000001
10000000001
10000200001
12000000001
10000000001
10000000201
100000000011111
10000N000011111
102000000011111
100000002011111
 111111111
