R 1000 1000

NO ./textures/wood.xpm

EA ./textures/grass.xpm

WE ./textures/metal.xpm

SO ./textures/brick.xpm

S ./textures/vase.xpm

F 209, 28, 189

C 217,244,255

 111111111
10000000001
10000000001
10111110001
10100010001
10111110001
10000000001
10000000001
10000200001
120000E0001
10000000001
10000000201
100000000011111
100000000011111
102000000011111
100000002011111
 111111111
